20
#.##################
#......#...........#
######.#.##.##.###.#
#.#....#..#.#..#.#.#
#.#.##.####.####.###
#.###...#.#.#.#....#
#.....#.#.....#.##.#
###.#####.#.#...#..#
#.#.#.#...#.#.#.####
#.....#####.#.#....#
#.###.#.#.#.#.####.#
#.#...#.#...#.#....#
#####.#.###.#.######
#.........#.#...#..#
#####.#####.#.#.##.#
#...........#.#.#..#
#.###########.#.##.#
#.#...#...#...#..#.#
#.#.#...#...#.##....
####################